30 15
-----#-#-#-#---#-#-#-#-------#
---------#-#-#-----#-#-------#
-----#--##-----#--##-#-------#
-###-------###-#####-#-------#
-#-------#-#-------#-#-------#
----#-####------#########-####
#####-------###-###----##-####
#-#-#-#--##-#-#-#--##-#-#-#--#
-#-#-#-#-#-#-#-#-#-#-#-#-#-#-#
#####---####-----#####---#####
-#---#-#-#-#---#-#-#-#---#-#-#
-#-#-----#-#-#-----#-#-#-----#
-----#--##-----#--##-----#--##
-###-#####-###-#####-###-#####
-#-------#-#-------#-#-------#