30 15
-------#------###---M---------
#########--P--#-##------------
---M----##--##-M-##-------M---
---------#-##-----#-----------
#####----###------#---M-------
----#-------------#-----------
-M--#-------------#########---
----####M####----M--------#---
-------#-#--#-----#########---
-------#-#--#-----####--------
####---#-#--#-------##---#####
---#---#-#--#----M--#----#---M
-M-#---###--#########----#-###
---#-------M-------------###M-
------------------------------