30 15
P-------------------------M---
############################--
-------------M-------------#--
-M------------------------M#--
--##########################--
--#--M------------------------
--#-----------------------M---
--##########################--
-----M---------------------#--
---------------------M-----#--
--##########################--
--#------------------M--------
-M#--M-----------------------M
--############################
------------------------------