30 15
-M---------------------##-----
####-#-----M--------M----#-M--
------#-----------------------
----M-#---------#---------##--
---#---#----M-----#----------#
----#--##------##-#-----M-----
--#--#---#----##---#---------#
-#--M----#----#-----#-------#-
------##---###---M---##-----#-
-##----#-#--#----------#----#-
--#---#--#-------#-----#-M---#
---#---##----###-P#-----#-##--
-M--------M---##---#--M--##-M-
----M--------------##---------
------------------------------